; Welcome Stranger!

[Map]
##############################
#               $$      # $ D#
#  $$$  #      ####   # # ####
# ##### ##            #$#    #
#       #  $         ## ###  #
#       #  #         $#      #
#       #       ## ##$#  $$ ##
#   P   #     #              #
#  ###  # ###        ####  ###

[Settings]
door_destination=level2
