; Level2
;

[Map]
################
#              #
#              #
#              #
#      P       #
################
#              #
#      D       #
################

; [Settings]
; door_destination=level2
