; Welcome Stranger!

[Map]
#########      #
#$ C  ###  #  $#
####    #  #####
#$ #          D#
## # # #####  ##
## #          ##
#PC     C      #
###  ######    #
################

[Settings]
door_destination=level3
