; Welcome Stranger!

[Map]
##############################
#  P          #              #
# ###       $ # $ ###  ####  #
#     #$$   $ # $    #      ##
##    ####    #              #
#                        ##$##
###$       $            ## $ #
#  $             ###   ### D #
# ### # ### ###       ########

[Settings]
door_destination=level3
