; Welcome Stranger!

[Map]
################
#              #
#$$$$$$$$$$$$$$#
#              #
#              #
#$$$$$$$$$$$$$$#
#$$$$$$$$$$$$$$#
#      P       #
################

[Settings]
door_destination=level3
