;
; # - Zeď
; P - Hráč (limit = 1)
; D - Dveře (limit = 1)
; $ - Mince (limit = 3)
;


[Map]
##############################
#         #  $$       #   D#
#           ####    # # ####
#  $$  ##           #$#    #
# #### #           ## ###  #
#      #  #         #      #
#      #      ## ##$#  $$ ##
#  P   #   ##              #
#  ##  #           ####  ###


[Settings]
door_destination=level2
