; Welcome Stranger!

[Map]
#T            T#
#              #
#     $$       #
#    $$$$      #
# P          D #
#####    #######
#####    #######
#####    #######
#####    #######

[Settings]
door_destination=level2
