; Welcome Stranger!
;
;
; ? - treasure chest
;

[Map]
#              #
#              #
#     $$       #
#    $$$$      #
# P          D #
#####    #######
#####    #######
#####    #######
#####    #######

[Settings]
door_destination=level2
